"filename", "language", "Dart", "comment", "blank", "total"
"c:\Users\Jeet\App Projects\find_easy\lib\firebase\auth_methods.dart", "Dart", 162, 14, 17, 193
"c:\Users\Jeet\App Projects\find_easy\lib\firebase\firestore_methods.dart", "Dart", 1, 0, 1, 2
"c:\Users\Jeet\App Projects\find_easy\lib\firebase\storage_methods.dart", "Dart", 21, 1, 8, 30
"c:\Users\Jeet\App Projects\find_easy\lib\firebase_options.dart", "Dart", 48, 12, 3, 63
"c:\Users\Jeet\App Projects\find_easy\lib\first_launch_detection.dart", "Dart", 34, 1, 10, 45
"c:\Users\Jeet\App Projects\find_easy\lib\main.dart", "Dart", 164, 5, 7, 176
"c:\Users\Jeet\App Projects\find_easy\lib\models\business_categories.dart", "Dart", 70, 0, 1, 71
"c:\Users\Jeet\App Projects\find_easy\lib\models\category_properties.dart", "Dart", 808, 1, 4, 813
"c:\Users\Jeet\App Projects\find_easy\lib\models\industry_segments.dart", "Dart", 5, 0, 1, 6
"c:\Users\Jeet\App Projects\find_easy\lib\models\membership_pricings.dart", "Dart", 17, 3, 1, 21
"c:\Users\Jeet\App Projects\find_easy\lib\models\user.dart", "Dart", 40, 0, 6, 46
"c:\Users\Jeet\App Projects\find_easy\lib\models\user_provider.dart", "Dart", 13, 0, 4, 17
"c:\Users\Jeet\App Projects\find_easy\lib\page\intro\intro_page_view.dart", "Dart", 109, 0, 8, 117
"c:\Users\Jeet\App Projects\find_easy\lib\page\main\add\add_page.dart", "Dart", 195, 1, 5, 201
"c:\Users\Jeet\App Projects\find_easy\lib\page\main\add\category\add_category.dart", "Dart", 297, 0, 16, 313
"c:\Users\Jeet\App Projects\find_easy\lib\page\main\add\category\category_products_add_page.dart", "Dart", 339, 0, 11, 350
"c:\Users\Jeet\App Projects\find_easy\lib\page\main\add\post\add_post_page.dart", "Dart", 198, 0, 16, 214
"c:\Users\Jeet\App Projects\find_easy\lib\page\main\add\post\select_product_for_post_page.dart", "Dart", 324, 0, 10, 334
"c:\Users\Jeet\App Projects\find_easy\lib\page\main\add\product\add_product_page_1.dart", "Dart", 819, 5, 26, 850
"c:\Users\Jeet\App Projects\find_easy\lib\page\main\add\product\add_product_page_2.dart", "Dart", 1703, 9, 33, 1745
"c:\Users\Jeet\App Projects\find_easy\lib\page\main\comments\all_comments_screen.dart", "Dart", 17, 0, 3, 20
"c:\Users\Jeet\App Projects\find_easy\lib\page\main\main_page.dart", "Dart", 68, 0, 7, 75
"c:\Users\Jeet\App Projects\find_easy\lib\page\main\profile\data\all_categories_page.dart", "Dart", 353, 1, 20, 374
"c:\Users\Jeet\App Projects\find_easy\lib\page\main\profile\data\all_post_page.dart", "Dart", 334, 1, 11, 346
"c:\Users\Jeet\App Projects\find_easy\lib\page\main\profile\data\all_product_page.dart", "Dart", 364, 4, 14, 382
"c:\Users\Jeet\App Projects\find_easy\lib\page\main\profile\details\business_details_page.dart", "Dart", 559, 7, 24, 590
"c:\Users\Jeet\App Projects\find_easy\lib\page\main\profile\details\owner_details_page.dart", "Dart", 452, 2, 17, 471
"c:\Users\Jeet\App Projects\find_easy\lib\page\main\profile\profile_page.dart", "Dart", 547, 0, 14, 561
"c:\Users\Jeet\App Projects\find_easy\lib\page\main\profile\tab_bar_page.dart", "Dart", 76, 0, 4, 80
"c:\Users\Jeet\App Projects\find_easy\lib\page\main\profile\view page\analytics\analaytics_page.dart", "Dart", 12, 0, 3, 15
"c:\Users\Jeet\App Projects\find_easy\lib\page\main\profile\view page\category\category_page.dart", "Dart", 733, 1, 24, 758
"c:\Users\Jeet\App Projects\find_easy\lib\page\main\profile\view page\posts\post_page.dart", "Dart", 226, 9, 19, 254
"c:\Users\Jeet\App Projects\find_easy\lib\page\main\profile\view page\product\product_category_change_page.dart", "Dart", 309, 0, 10, 319
"c:\Users\Jeet\App Projects\find_easy\lib\page\main\profile\view page\product\product_image_page.dart", "Dart", 80, 1, 7, 88
"c:\Users\Jeet\App Projects\find_easy\lib\page\main\profile\view page\product\product_page.dart", "Dart", 1107, 27, 50, 1184
"c:\Users\Jeet\App Projects\find_easy\lib\page\register\business_register_details.dart", "Dart", 276, 9, 17, 302
"c:\Users\Jeet\App Projects\find_easy\lib\page\register\firestore_info.dart", "Dart", 5, 0, 2, 7
"c:\Users\Jeet\App Projects\find_easy\lib\page\register\login_page.dart", "Dart", 327, 10, 6, 343
"c:\Users\Jeet\App Projects\find_easy\lib\page\register\membership.dart", "Dart", 400, 4, 16, 420
"c:\Users\Jeet\App Projects\find_easy\lib\page\register\register_cred.dart", "Dart", 413, 7, 18, 438
"c:\Users\Jeet\App Projects\find_easy\lib\page\register\register_pay.dart", "Dart", 88, 1, 5, 94
"c:\Users\Jeet\App Projects\find_easy\lib\page\register\user_register_details.dart", "Dart", 230, 0, 7, 237
"c:\Users\Jeet\App Projects\find_easy\lib\page\register\verify\email_verify.dart", "Dart", 86, 1, 16, 103
"c:\Users\Jeet\App Projects\find_easy\lib\page\register\verify\number_verify.dart", "Dart", 131, 1, 8, 140
"c:\Users\Jeet\App Projects\find_easy\lib\provider\add_product_provider.dart", "Dart", 8, 0, 4, 12
"c:\Users\Jeet\App Projects\find_easy\lib\provider\change_category_provider.dart", "Dart", 14, 0, 5, 19
"c:\Users\Jeet\App Projects\find_easy\lib\provider\products_added_to_category_provider.dart", "Dart", 17, 0, 6, 23
"c:\Users\Jeet\App Projects\find_easy\lib\provider\select_product_for_post_provider.dart", "Dart", 22, 1, 10, 33
"c:\Users\Jeet\App Projects\find_easy\lib\provider\shop_type_provider.dart", "Dart", 15, 0, 2, 17
"c:\Users\Jeet\App Projects\find_easy\lib\provider\sign_in_method_provider.dart", "Dart", 27, 0, 9, 36
"c:\Users\Jeet\App Projects\find_easy\lib\user_one_product_page.dart", "Dart", 0, 379, 20, 399
"c:\Users\Jeet\App Projects\find_easy\lib\utils\colors.dart", "Dart", 9, 0, 2, 11
"c:\Users\Jeet\App Projects\find_easy\lib\widgets\additional_info_box.dart", "Dart", 50, 0, 4, 54
"c:\Users\Jeet\App Projects\find_easy\lib\widgets\button.dart", "Dart", 51, 0, 4, 55
"c:\Users\Jeet\App Projects\find_easy\lib\widgets\collapse_container.dart", "Dart", 77, 0, 5, 82
"c:\Users\Jeet\App Projects\find_easy\lib\widgets\head_text.dart", "Dart", 30, 0, 4, 34
"c:\Users\Jeet\App Projects\find_easy\lib\widgets\image_container.dart", "Dart", 32, 0, 3, 35
"c:\Users\Jeet\App Projects\find_easy\lib\widgets\image_pick_dialog.dart", "Dart", 81, 0, 4, 85
"c:\Users\Jeet\App Projects\find_easy\lib\widgets\image_picker.dart", "Dart", 11, 0, 5, 16
"c:\Users\Jeet\App Projects\find_easy\lib\widgets\image_text_container.dart", "Dart", 66, 1, 7, 74
"c:\Users\Jeet\App Projects\find_easy\lib\widgets\info_box.dart", "Dart", 52, 0, 4, 56
"c:\Users\Jeet\App Projects\find_easy\lib\widgets\info_edit_box.dart", "Dart", 133, 0, 4, 137
"c:\Users\Jeet\App Projects\find_easy\lib\widgets\membership_card.dart", "Dart", 203, 1, 5, 209
"c:\Users\Jeet\App Projects\find_easy\lib\widgets\page_view.dart", "Dart", 57, 1, 4, 62
"c:\Users\Jeet\App Projects\find_easy\lib\widgets\snack_bar.dart", "Dart", 9, 0, 2, 11
"c:\Users\Jeet\App Projects\find_easy\lib\widgets\text_button.dart", "Dart", 27, 0, 4, 31
"c:\Users\Jeet\App Projects\find_easy\lib\widgets\text_form_field.dart", "Dart", 118, 0, 6, 124
"Total", "-", 13669, 521, 633, 14823